  0  1  2  2  2  2  2  2  2  2  0  0  0  0  2  2  2  2  0  0  0  2  0  2  2  2  2  0  0  0  0  0  0  2  2  2  2  2  2  2  2  2  2  2  0  0  0  2  2  2  2  2  2  2  2  2  2  0  0  0  0  0  0  0  2  2  2  2  2  2  2  2  2  2  2  2  2  2  2  2  2  2  2  2  2  2  2  2  2  2  2  2  2  0  2  0  0  0  2  2  2  2  2  2  2  2  2  2  2  2  2  2  2  2  2  2  2  2  2  2  2  2  2  2  2  2  2  2  2  2  2  2  2  2  2  2  2  2  0  0  0  0  0
  0  1  2  2  2  2  2  2  2  2  0  0  0  0  2  2  0  0  0  0  0  0  0  0  2  2  2  0  0  0  0  0  0  2  2  2  2  2  2  2  2  2  2  2  0  0  0  0  2  2  2  2  2  2  2  2  2  0  0  0  0  0  0  0  0  0  0  2  2  2  2  2  2  2  2  2  2  2  2  2  2  2  0  0  2  2  2  2  2  2  2  2  0  0  0  0  0  2  2  0  0  0  2  2  0  0  2  2  2  2  2  2  2  2  2  2  2  2  2  2  2  2  2  2  2  2  2  2  2  2  2  2  2  2  2  2  2  0  0  0  0  0  0
  0  1  2  2  2  2  2  2  2  2  2  0  0  2  2  2  0  0  0  0  0  0  0  0  2  2  2  2  0  0  0  0  0  2  2  2  2  2  2  2  2  2  2  2  0  0  0  0  2  2  2  2  2  2  2  0  0  0  0  0  0  0  0  0  0  0  0  0  2  2  2  2  2  2  2  2  2  2  0  0  0  0  0  0  2  2  2  2  2  2  2  2  0  0  0  0  0  0  0  0  0  0  0  0  0  0  2  2  2  2  2  2  2  2  2  2  2  2  2  2  2  2  0  0  0  2  2  2  2  2  2  2  2  2  2  2  2  0  0  0  0  0  0
  0  1  2  2  2  2  2  2  2  2  2  2  2  2  2  2  2  0  0  0  0  0  2  2  2  2  2  2  0  0  2  0  0  2  2  2  2  0  0  2  2  2  2  2  0  0  0  2  2  2  2  2  2  2  0  0  0  0  0  0  0  0  0  0  0  0  0  0  2  2  2  2  2  2  2  2  2  2  0  0  0  0  0  0  0  2  2  2  2  2  2  2  2  2  0  0  0  0  0  2  0  0  0  0  0  0  2  2  2  2  2  2  2  2  2  2  2  2  2  2  2  2  0  0  2  2  2  2  2  2  2  2  2  2  2  2  2  2  2  2  0  0  0
  0  1  2  2  2  2  2  2  2  2  2  2  2  2  2  2  2  2  0  0  0  0  0  2  2  2  2  2  2  2  2  2  2  0  0  2  2  0  0  2  2  2  2  2  2  2  2  2  2  2  2  2  2  2  0  0  0  0  0  2  0  0  0  0  2  0  2  0  2  2  2  2  2  0  0  2  2  2  0  0  0  0  0  0  0  0  2  2  2  2  2  2  2  0  0  0  0  0  2  0  0  0  0  0  0  0  2  2  2  2  2  2  2  2  2  2  2  2  2  2  2  2  0  0  0  2  2  2  2  2  2  2  2  2  2  2  2  2  2  2  0  0  0
  0  1  2  2  2  2  2  2  2  2  2  2  2  2  2  2  2  0  0  0  0  0  0  2  2  2  2  2  2  2  2  2  2  0  0  0  0  0  0  2  2  2  2  2  2  2  2  2  2  2  2  2  2  2  2  0  0  0  0  0  0  0  0  2  0  0  0  0  0  2  0  0  0  0  0  2  2  2  2  0  0  0  0  0  0  0  2  2  2  2  2  2  2  0  0  2  0  0  2  0  0  0  0  0  0  0  0  2  2  2  2  2  2  2  2  0  0  0  0  2  2  0  0 10  2  2  2  2  2  2  2  2  2  2  2  2  2  2  2  2  2  0  0
  0  1  2  2  2  2  2  2  2  2  2  2  2  2  2  2  2  0  0  0  2  2  0  2  2  2  2  2  2  2  2  2  2  2  0  0  0  0  0  0  0  2  2  2  2  2  2  2  0  0  0  2  2  2  2  2  2  0  0  0  0  0  0  2  0  0  0  0  0  2  2  0  0  0  0  0  2  2  0  0  0  0  0  0  2  2  2  2  2  2  2  2  2  2  2  2  0  0  2  0  0  0  0  0  0  0  0  2  2  2  2  2  2  2  2  2  0  0  0  0 10 10 10 10 11 11 11  2  2  2  2  2  2  2  2  2  2  2  2  2  2  2  2
  0  1  2  2  2  2  2  0  0  0  2  2  2  2  2  2  2  2  2  2  2  2  2  2  2  2  2  2  2  2  2  2  2  2  0  0  0  0  0  0  0  2  2  2  2  2  2  2  0  0  0  2  0  2  2  2  0  0  0  0  0  0  0  0  0  0  0  0  0  2  0  0  0  0  0  0  2  2  0  0  0  0  0  0  2  2  2  2  2  2  2  2  2  2  2  2  2  2  2  2  2  0  0  0  2  2  2  2  2  2  2  2  2  2  2  2  0  0  0 10 10 10 10 10 11 11 11 11  2  2  2  2  2  2  2  0  0  2  2  2  2  2  2
  0  1  2  2  2  2  0  0  0  0  2  2  2  2  2  2  2  2  2  2  2  2  2  2  2  2  2  2  2  2  2  2  2  0  0  0  0  0  0  2  2  2  2  2  2  2  0  2  2  0  0  0  0  0  2  2  0  0  0  0  0  0  0  0  0  0  0  0  0  2  0  0  0  0  2  2  2  2  2  2  2  2  0  0  2  2  2  2  2  2  2  2  2  2  2  2  2  2  2  2  2  2  0  0  2  2  2  2  2  2  2  2  2  2  2  2  2 10 10 10 10 10 10 15 11 11 11 11  2  2  2  2  0  0  0  0  0  0  2  2  2  2  2
  0  1  2  2  2  2  0  0  0  0  2  2  2  2  2  2  2  2  2  2  2  2  2  2  2  2  2  0  0  0  2  2  2  0  0  0  0  0  0  2  2  2  2  2  2  2  0  0  0  0  0  0  0  0  2  2  2  0  0  0  0  0  2  0  0  0  0  0  0  2  2  2  0  0  0  2  2  2  2  2  2  2  2  2  2  2  2  2  2  2  2  2  2  2  2  2  2  2  2  2  2  2  2  2  2  2  2  2  2  2  2  2  2  2  2  2 10 10 10 10 15 15 15 15 15 15 11 11 11  2  2  2  0  0  0  0  0  2  2  2  2  2  2
  0  1  2  2  2  2  2  0  0  0  2  2  2  2  2  2  2  2  2  2  2  2  2  2  2  2  0  0  0  0  2  2  2  2  2  2  2  0  0  2  2  2  2  2  2  2  2  0  0  0  0  0  2  2  2  2  2  0  0  0  2  2  2  2  0  0  0  2  2  2  2  2  2  2  2  2  2  2  2  2  2  2  2  2  2  2  2  2  2  2  2  2  0  0  2  2  2  2  2  2  2  2  2  2  2  2  2  2  2  2  2  2  9  9  9 10 10 10 10 15 15 15 15 15 15 15 15 11 11 11  2  2  2  0  0  0  0  0  0  2  2  2  2
  0  1  2  2  2  2  2  2  2  2  2  2  2  2  2  2  2  2  2  2  2  2  2  2  2  2  0  0  0  0  2  2  2  2  2  2  2  2  2  2  2  2  2  2  2  2  2  2  0  0  0  0  0  2  2  2  2  2  2  2  2  2  2  2  2  2  2  2  2  2  2  2  2  2  2  2  2  2  2  2  2  2  2  2  2  2  2  2  2  2  2  2  0  0  0  0  0  2  2  2  2  2  2  2  2  2  2  2  2  9  9  9  9  9  9 10 10 10 17 15 15 15 15 20 15 15 15 11 11 11  2  2  2  2  0  0  0  0  0  2  2  2  2
  0  1  2  2  2  2  2  2  2  2  2  2  2  2  2  2  0  0  0  2  2  2  2  2  2  2  2  0  0  0  2  2  2  2  2  2  2  2  2  2  2  2  2  2  2  2  2  2  0  0  2  0  0  2  2  2  2  2  2  2  2  2  2  2  2  2  2  2  2  2  2  2  2  2  2  0  0  0  2  2  2  2  2  2  2  2  0  0  2  2  2  0  0  0  0  0  2  2  2  2  2  2  2  2  2  2  2  2  9  9  9  9  9  9  9  9 17 17 17 15 20 20 20 20 20 15 15 15 11 11 11  2  2  2  2  2  0  0  0  2  2  2  2
  0  1  2  2  2  2  2  0  0  2  2  0  0  2  2  2  0  0  0  2  0  2  2  2  2  2  2  2  2  2  2  2  2  2  2  2  2  2  2  2  2  2  2  2  2  2  0  2  0  0  0  0  2  2  2  2  2  2  2  2  2  2  2  2  2  2  2  2  2  2  2  2  2  2  0  0  0  0  0  0  2  2  2  2  0  0  0  0  2  2  2  0  0  0  0  0  0  2  2  0  2  2  2  2  2  2  2  2  9  9  9 17 17 17 17 17 17 17 17 17 20 20 20 20 20 15 15 15 11 11 11 12  2  2  2  3  3  2  2  2  2  2  2
  0  1  2  2  2  2  2  0  0  0  0  0  0  2  0  0  0  0  0  0  0  0  2  2  2  2  2  2  2  2  2  2  2  2  2  2  2  2  2  2  2  2  2  2  2  2  0  0  2  0  0  0  2  2  2  2  2  2  2  2  2  2  2  2  2  2  2  2  2  2  2  2  2  2  0  0  0  0  0  0  2  2  2  2  0  0  0  0  0  0  2  2  2  0  0  0  0  2  2  0  0  0  2  0  0  0  2  9  9  9 17 17 17 17 17 17 17 17 17 20 20 20 23 20 20 20 15 16 16 11 12 12 12 12  3  3  3  3  2  2  2  2  2
  0  1  2  2  2  2  2  0  0  0  0  0  2  2  0  0  0  0  0  0  0  0  2  2  2  2  2  2  2  2  2  2  2  2  2  2  2  2  2  2  2  2  2  2  2  2  0  0  0  0  0  2  2  2  2  0  0  2  2  2  2  2  2  2  2  2  2  2  2  2  2  2  2  2  0  0  0  0  0  0  2  2  2  2  2  0  0  0  0  2  2  2  0  0  2  2  2  2  2  0  0  0  0  0  0  0  2  9  9  9 17 17 17 17 19 20 20 20 20 20 20 23 23 24 20 21 16 16 16 16 12 12 12 12 12  3  3  3  3  2  2  2  2
  0  1  0  0  2  2  2  0  0  0  0  0  0  2  2  0  0  0  0  0  2  2  2  2  2  2  2  2  2  2  2  2  2  2  2  2  2  2  0  0  0  0  2  2  2  2  0  0  0  0  0  0  2  2  0  0  0  2  2  2  2  2  2  2  2  2  2  2  2  2  2  2  2  2  2  0  0  0  0  0  2  2  2  2  0  0  0  0  0  2  2  2  2  2  2  2  2  2  2  0  0  0  0  0  0  2  2  9  9  9 17 17 17 19 19 19 20 20 20 20 20 23 23 24 21 21 21 16 16 16 16 16 12 12 12 12  3  3  3  2  2  2  2
  0  1  0  0  2  2  0  0  0  0  0  0  0  0  2  2  0  0  0  0  0  2  2  2  2  2  2  2  2  2  2  2  2  2  2  2  2  0  0  0  0  0  0  0  0  0  0  0  0  0  0  0  0  2  0  0  0  2  0  0  0  2  2  2  2  2  2  2  2  2  2  2  2  2  2  0  0  2  0  0  2  0  0  2  0  0  2  0  0  2  2  2  2  2  2  2  2  0  0  0  0  0  0  0  0  2  2  8  9  9 16 16 17 19 19 19 23 23 23 23 23 23 24 24 21 21 21 21 21 16 16 16 16 12 12 12 12  3  3  3  2  2  2
  0  1  0  0  2  2  0  0  0  0  0  0  0  0  2  0  0  0  0  0  0  2  2  2  2  2  2  2  2  2  2  2  2  2  2  2  2  0  0  0  0  0  0  0  0  0  0  0  0  0  0  0  0  0  0  0  0  0  0  0  0  2  2  2  2  2  2  2  2  2  2  2  2  2  2  2  0  0  0  2  0  0  0  2  2  2  2  2  2  2  2  2  2  0  0  2  2  0  0  0  0  0  0  0  0  0  2  8  8  8 16 16 16 19 19 23 23 23 23 23 23 23 24 24 21 21 21 21 21 21 21 16 16 16 12 12 12  3  3  3  2  2  2
  0  1  0  0  0  2  2  2  2  0  0  2  2  2  2  0  0  0  2  2  0  2  2  2  2  2  2  2  2  2  2  2  2  2  2  2  2  2  0  0  0  0  0  0  2  2  2  2  0  0  2  0  0  0  0  0  0  0  0  0  0  2  2  0  0  0  2  2  2  2  2  2  2  2  2  2  0  0  0  0  0  0  0  2  2  2  2  2  2  2  2  2  2  0  0  0  0  0  0  0  0  0  0  0  0  0  0  8  8  8 16 16 16 19 19 19 23 23 23 23 23 23 24 24 24 24 24 24 21 21 21 16 16 16 12 12 12  3  3  3  2  2  2
  0  1  0  0  0  2  2  2  2  0  0  2  2  2  2  2  2  2  2  2  2  2  2  2  2  2  2  2  2  2  2  2  2  2  2  2  0  0  0  0  0  0  0  0  2  2  2  2  0  0  2  2  2  0  0  0  0  0  0  2  2  0  0  0  0  0  0  2  2  2  2  2  2  2  2  2  2  0  0  0  0  0  0  2  2  2  2  2  2  2  2  2  2  2  0  0  0  0  0  2  0  0  0  2  0  0  0  0  8  8  8 16 16 16 19 19 23 23 23 23 25 25 25 24 24 24 24 24 21 21 21 16 16 16 12 12 12  3  3  3  2  2  2
  0  1  0  0  0  2  2  2  2  2  2  2  2  2  2  2  2  2  2  2  2  2  2  2  2  2  2  2  2  2  2  2  2  2  2  0  0  0  0  0  0  0  0  0  0  2  2  2  2  2  2  2  2  0  0  0  0  0  0  2  2  0  0  0  0  0  0  2  2  2  2  2  2  2  2  2  2  0  0  0  0  0  0  0  0  2  2  2  2  2  2  2  2  0  0  0  0  0  0  2  0  0  0  2  2  0  0  0  8  8  8 16 16 16 19 19 19 23 23 23 24 24 24 24 24 24 21 21 21 21 16 16 16 12 12 12  3  3  3  2  2  2  2
  0  1  0  2  2  2  2  2  2  0  0  2  2  2  2  2  2  2  2  2  2  2  2  2  2  2  2  2  2  2  2  2  2  2  2  2  0  0  0  0  0  0  0  0  0  0  0  0  2  2  2  2  2  0  0  0  0  0  0  0  2  0  0  0  0  0  0  2  2  2  2  2  2  2  2  2  0  0  0  0  0  0  0  0  0  2  2  2  2  2  2  2  0  0  0  0  0  0  0  0  2  0  0  0  0  0  0  0  8  8  8 16 16 16 19 19 19 23 23 24 24 24 24 24 24 21 21 21 21 16 16 16 16 13 13 12  4  3  3  2  2  2  2
  0  1  2  2  2  2  2  2  0  0  0  0  2  2  2  2  2  2  2  2  2  2  2  2  0  0  0  2  2  2  2  2  2  2  2  2  2  2  2  0  0  0  0  0  0  0  0  0  0  0  2  2  2  0  0  0  2  0  0  0  2  0  0  0  0  0  2  2  2  2  2  2  2  2  2  0  0  0  0  0  0  0  0  0  0  2  2  2  2  2  2  2  0  0  0  0  0  0  0  0  2  2  0  0  0  0  0  0  0  8  8  8 16 16 19 19 19 23 23 24 24 24 24 24 24 22 21 17 17 17 17 13 13 13 13  4  4  4  2  2  2  2  2
  0  1  2  2  2  2  2  2  0  0  0  0  2  2  2  2  2  0  0  2  2  2  2  2  0  0  0  0  2  2  2  2  2  2  2  2  2  2  2  0  0  0  2  2  0  0  0  0  0  0  2  2  2  0  2  2  2  2  2  2  2  0  0  0  0  0  2  2  2  2  2  2  2  2  2  0  0  0  2  0  0  0  2  2  2  2  2  2  2  2  2  2  2  2  2  0  0  2  2  2  2  2  2  2  0  0  0  0  0  8  8 16 16 16 19 19 23 23 22 24 22 22 24 24 24 22 22 17 17 17 13 13 13 13  4  4  4  4  2  2  2  2  2
  0  1  2  2  2  2  2  2  0  0  0  0  2  2  0  0  2  0  0  0  2  2  2  2  0  0  0  0  2  2  2  2  2  2  0  0  2  2  2  0  0  2  2  2  0  0  0  0  0  2  2  2  2  2  2  2  2  2  2  2  2  2  2  2  2  2  2  2  2  2  2  2  2  2  2  2  2  2  2  0  0  0  2  2  2  2  2  2  2  2  2  2  2  2  2  0  0  2  2  2  2  2  2  0  0  0  0  0  0  8  8 16 16 16 19 19 22 22 22 22 22 22 22 22 24 22 22 17 17 17 13 13 13  4  4  4  4  2  2  2  2  2  2
  0  1  2  2  2  2  2  2  2  2  2  2  2  2  0  0  0  0  0  2  2  2  2  2  0  0  0  2  2  2  2  0  2  0  0  0  2  2  2  2  2  2  2  2  2  0  0  0  0  0  2  2  2  2  2  2  2  2  2  2  2  2  2  2  2  2  2  2  2  2  2  2  2  2  2  2  2  2  2  0  0  0  2  2  2  2  2  2  2  2  2  2  2  2  2  2  2  2  2  2  2  2  2  0  0  0  0  0  0  8  8 16 16 15 18 18 22 22 22 22 18 18 22 22 22 22 22 17 17 13 13 13  4  4  4  4  2  2  2  2  2  2  2
  0  1  2  2  2  2  2  2  2  2  2  2  2  2  2  0  0  0  0  0  0  2  2  2  2  2  2  2  2  2  0  0  0  0  0  2  0  0  2  2  2  2  2  2  2  0  0  2  0  0  2  2  2  2  2  0  0  2  2  2  2  2  2  2  2  2  2  2  2  2  2  2  2  2  2  2  2  2  2  2  2  2  2  2  2  2  2  2  2  2  2  2  2  2  2  2  2  2  2  2  2  2  2  0  2  2  0  0  7  7  7 15 15 15 18 18 18 18 18 18 18 18 18 22 22 22 22 17 17 13 13 13  4  4  4  0  2  2  2  2  2  2  2
  0  1  2  2  2  2  2  2  2  2  2  2  2  0  0  0  0  0  0  0  0  2  2  2  2  2  2  2  2  2  0  0  0  0  0  0  0  0  2  2  2  2  2  0  0  2  2  2  2  2  2  0  0  0  2  0  0  2  2  2  2  2  2  2  2  2  2  2  2  2  2  2  2  2  2  2  2  2  2  2  2  2  2  2  2  2  2  2  2  2  2  2  2  0  0  0  2  2  0  2  2  2  2  2  2  2  2  2  7  7  7 15 15 15 18 18 18 18 18 18 18 18 18 18 22 22 17 17 17 13 13 13  4  4  4  0  0  0  0  2  2  2  2
  0  1  2  2  2  2  2  2  2  2  2  2  2  0  0  0  0  0  2  0  0  2  2  2  2  2  2  2  2  2  2  2  0  0  0  0  0  2  2  0  0  0  0  0  0  2  2  2  2  2  2  0  0  0  0  0  0  2  2  2  2  2  2  2  2  2  2  2  2  2  2  2  2  2  2  2  2  2  2  2  2  2  2  2  2  0  0  2  2  0  0  2  2  0  0  0  0  0  0  2  2  2  2  2  2  2  2  2  2  7  7 15 15 15 15 15 18 18 15 15 15 14 18 18 17 17 17 17 17 13 13 13  4  4  4  0  0  0  0  2  2  2  2
  0  1  2  2  2  2  2  2  2  2  2  2  2  2  0  2  0  0  0  2  2  2  2  2  2  2  2  2  2  2  2  0  0  0  0  0  2  2  2  0  0  0  0  0  0  0  0  2  2  2  2  2  0  0  0  0  0  0  0  2  2  0  0  0  2  2  2  2  2  2  2  2  0  0  0  0  2  2  2  2  2  2  2  2  2  0  0  0  0  0  0  2  2  2  0  0  0  0  0  2  2  2  2  2  2  2  2  2  2  7  7  7 15 15 15 15 15 15 15 15 15 14 14 18 17 17 17 17 14 14 13  5  5  4  0  0  0  0  0  2  2  2  2
  0  1  2  2  2  2  2  2  2  2  2  2  2  2  2  2  0  0  0  2  2  2  2  2  2  2  2  2  2  2  2  0  0  2  0  0  0  2  2  0  0  0  0  0  0  0  0  2  2  2  2  0  0  0  0  0  0  0  0  0  2  0  0  0  2  2  2  2  2  2  2  2  0  0  0  0  2  2  2  2  2  2  2  2  2  0  0  0  0  0  2  2  0  0  0  0  0  0  0  2  2  2  2  2  2  2  2  2  2  7  7  7  7 15 15 15 15 15 15 15 14 14 14 14 14 14 14 14 14 14 13  5  5  5  0  0  0  0  2  2  2  2  2
  0  1  2  2  2  2  2  2  2  2  2  2  2  2  2  2  2  2  2  2  2  2  2  2  2  0  0  0  2  2  2  2  2  2  0  0  2  2  2  2  0  0  0  0  0  0  0  2  2  2  2  0  0  0  0  0  0  0  0  0  0  0  0  0  0  0  2  2  2  2  2  2  0  0  0  0  2  2  2  2  2  2  2  2  2  0  0  0  0  0  0  2  0  0  0  0  0  0  0  0  2  2  2  2  2  0  0  2  2  7  7  7  7  7  7  7  7  6  6  6  6  6 14 14 14 14 14 14 14 14  5  5  5  0  0  0  0  0  0  2  2  2  2
  0  1  2  2  2  2  2  2  2  2  2  2  2  2  2  2  2  2  2  2  2  2  2  2  2  0  0  0  0  0  2  2  2  0  0  2  2  2  2  2  0  0  0  0  0  2  2  2  2  2  2  0  0  0  0  0  0  2  0  0  0  0  0  0  0  0  2  2  2  2  2  2  0  0  0  2  2  2  2  2  2  2  2  2  0  0  0  0  0  0  0  0  0  0  0  0  0  0  0  0  2  2  2  2  0  0  0  2  2  2  2  7  7  7  7  7  6  6  6  6  6  6  6 14 14 14 14 14 14  5  5  5  5  0  0  0  0  0  0  2  2  2  2
  0  1  2  2  0  0  0  2  2  2  2  2  2  2  2  2  2  2  2  2  2  2  2  2  0  0  0  0  0  0  2  2  0  0  0  2  2  2  2  0  0  0  0  0  0  2  2  2  2  2  2  2  2  2  0  0  0  2  2  2  0  0  0  0  0  2  2  2  2  2  2  2  2  2  2  2  2  2  2  2  2  2  2  2  0  0  0  0  0  0  0  0  2  2  0  0  0  2  0  2  2  2  2  2  0  0  0  2  0  0  0  2  7  7  7  6  6  6  6  6  6  6  6  6  6  5  5  5  5  5  5  5  2  0  0  2  2  2  2  2  2  2  2
  0  1  2  0  0  0  0  2  2  2  2  2  2  2  2  2  2  0  0  2  2  2  2  2  0  0  0  0  0  0  2  2  0  0  0  2  0  0  0  2  2  2  2  0  0  2  2  2  2  2  2  2  2  2  2  2  2  2  2  0  0  0  0  0  2  2  2  2  2  2  2  2  2  2  2  2  2  2  2  2  2  2  2  2  2  2  2  0  0  2  2  2  2  2  0  0  0  2  2  2  2  0  0  0  0  0  0  0  0  0  0  2  2  2  2  2  2  2  2  2  0  0  6  6  6  5  5  5  5  5  5  2  2  2  2  2  2  2  2  2  2  2  2
  0  1  2  0  0  0  0  2  2  2  2  2  2  2  2  2  2  0  0  2  2  2  2  2  2  0  0  0  0  0  0  0  0  0  0  0  0  0  0  2  2  2  2  2  2  2  2  2  2  2  2  2  2  2  2  2  2  2  2  0  0  0  0  0  0  2  2  2  2  2  2  2  2  2  2  2  2  2  2  2  2  2  2  2  2  2  2  0  0  2  2  2  2  2  2  2  2  2  2  2  2  0  0  0  0  0  0  0  0  0  2  2  2  2  2  2  2  2  2  2  0  0  0  2  6  5  5  5  5  5  2  2  2  2  2  2  2  2  2  2  2  0  0
  0  1  2  2  0  0  0  2  2  2  2  2  2  2  0  0  0  0  0  0  0  0  2  2  2  0  0  0  0  0  0  0  0  0  0  0  0  0  0  2  2  2  2  2  2  2  2  0  0  0  0  0  2  2  0  0  0  0  0  0  0  0  0  0  0  0  0  0  2  0  0  2  2  2  2  2  2  2  2  2  0  0  0  2  2  0  2  2  2  2  2  2  2  2  2  2  2  2  2  2  2  2  2  0  0  0  0  0  2  2  2  2  2  2  2  2  2  2  2  0  0  0  0  2  2  2  2  2  2  2  2  2  2  2  2  2  2  2  2  2  2  0  0
  0  1  2  2  2  2  2  2  2  2  2  2  2  2  0  0  0  0  0  0  0  0  2  2  2  2  2  2  2  2  2  0  0  0  0  0  0  2  2  2  2  2  2  2  2  2  2  0  0  0  0  0  2  2  0  0  0  0  0  0  0  0  0  0  0  0  0  0  2  0  0  0  0  0  0  2  2  2  2  2  0  0  0  0  0  0  2  2  2  2  2  2  2  2  2  2  2  2  2  2  2  2  2  0  0  0  0  0  0  2  2  2  2  2  2  2  2  2  2  2  0  0  2  2  2  2  2  2  2  2  2  2  2  2  2  2  2  0  2  0  2  0  0
  0  1  2  2  2  2  2  2  2  2  2  2  2  2  2  2  0  0  0  0  2  2  2  2  2  2  2  2  2  2  2  0  0  0  0  0  0  2  2  2  2  2  2  2  2  2  0  0  0  0  0  0  2  2  2  0  0  0  0  0  0  0  0  0  0  0  0  0  2  0  0  0  0  0  0  2  2  2  2  2  0  0  0  0  0  0  2  2  2  2  2  2  2  2  2  2  2  2  2  2  2  2  2  0  0  0  0  0  0  0  2  2  2  2  2  2  2  2  2  2  0  0  2  2  2  2  2  2  2  2  2  2  2  2  2  2  2  0  0  0  0  0  0
  0  1  2  2  2  2  2  2  2  2  2  2  2  2  2  0  0  0  0  0  0  2  2  2  2  2  2  2  2  2  2  0  0  0  0  0  0  0  2  2  2  2  2  2  2  2  0  0  0  0  0  0  2  2  2  2  2  2  0  0  0  0  0  0  2  2  2  0  0  0  0  0  0  0  0  2  2  2  2  0  0  0  0  0  0  0  0  2  2  2  2  2  2  2  2  2  2  2  2  2  2  2  2  0  0  0  2  0  0  0  2  2  2  2  2  2  2  2  2  2  2  2  2  2  2  2  2  2  2  2  2  2  2  2  2  2  2  0  0  0  0  0  0